ˈsaːz: I
ˈisiz: and
ˈsih: in
ˈahih: not
ˈuʃiz: you (singular)
ˈuʃaːh: you (plural)
ˈtʃaz: with
ˈiːpiz: they (singular)
ˈpaːh: they (plural)
ˈaːxuh: at
ˈhih: this
ˈaʃiːh: we
ˈihuːh: that
ˈifuh: to say
ˈhaːz: what
ˈhuːz: all
ˈxah: if
ˈaxiz: who
ˈfaz: one
ˈpiːh: to see
ˈhaz: to know
ˈʃuːh: some
ˈtih: year
ˈʃuːh: two
ˈihuz: to think
ˈhaːxaz: to come
ˈsuːz: other
ˈatuh: to give
ˈxiz: good
ˈuhih: new
ˈuxuh: how
ˈfih: man (adult male)
ˈasih: man (human being)
ˈkufuh: day
ˈufih: many
ˈaːʃuh: because
ˈsuːpah: three
ˈihuːh: there
ˈxaːhuh: child
ˈʃuːz: here
ˈiːtaz: old
ˈpuz: woman
ˈsufah: where
ˈihuh: hand
ˈfaːh: small
ˈuxaːz: to hold
ˈʃaːh: four
ˈisaːh: to turn (intransitive)
ˈtʃahaːz: few
ˈfusaz: when
ˈutih: five
ˈsusuz: head
ˈpuh: night
ˈxihaːh: long
ˈfuːh: eye
ˈfuh: to play
ˈsutuh: water
ˈfiːfah: to hear
ˈupuh: right
ˈuhah: big
ˈisuːh: to live
ˈhukuz: to stand
ˈafih: name
ˈhasah: road
ˈfaʃiz: to sit
ˈaːsaz: mother
ˈfuxaz: full
ˈixah: far
ˈhaːh: to fall
ˈisiːh: bad
ˈukiːh: father
ˈaʃah: black
ˈxuh: to die
ˈxaʃuːz: to walk
ˈtʃiːh: foot
ˈsuh: back
ˈtʃaːhaz: white
ˈsuːh: short
ˈsiːz: wife
ˈtʃuh: to lie (as in a bed)
ˈtaz: to cut
ˈxiːfuh: wide
ˈtah: to kill
ˈxuxaːz: animal
ˈxasuːz: heart
ˈhixaːz: hair
ˈaxih: tree
ˈxasah: bark (of a tree)
ˈxaːsuh: fire
ˈupiz: to eat
ˈhiːz: to pull
ˈifuh: sea
ˈkaxaːh: red
ˈsisih: dog
ˈxupuːh: husband
ˈpuːh: leg
ˈkah: to throw
ˈʃah: sun
ˈuːsaz: river
ˈtʃiz: stone
ˈapiːz: to fight
ˈpihiz: to hit
ˈhuʃih: to push
ˈxiʃiz: heavy
ˈaːsah: fish
ˈxah: cold
ˈsufuz: blood
ˈitʃiːh: green
ˈhaːsih: star
ˈpaːz: mouth
ˈtuːhuz: to laugh
ˈtuːhah: earth
ˈiːtʃuh: left
ˈiʃuh: bird
ˈsuːxuz: forest
ˈuːxuh: to fly
ˈuxaz: wind
ˈixaz: flower
ˈsah: skin
ˈkah: to drink
ˈkiːxuz: warm
ˈkaːh: to sleep
ˈpuxiːh: mountain
ˈxaxuh: rain
ˈʃuh: to sing
ˈʃaz: egg
ˈfiːkih: neck
ˈtʃuːz: ear
ˈatah: correct
ˈiʃuːz: thin
ˈsatuh: sky
ˈfah: dry
ˈukuh: narrow
ˈfuːxiz: tooth
ˈuːhaz: wing
ˈxipih: to fear
ˈtʃah: to burn
ˈkusaːh: thick
ˈakaz: fruit
ˈtaːz: leaf
ˈpufaːz: to blow
ˈiʃih: lake
ˈxiːz: to sew
ˈuhiz: to count
ˈfaːh: to wash
ˈʃuːfah: nose
ˈfuːz: bone
ˈpah: knee
ˈixuːz: root
ˈhuh: grass
ˈsuh: sharp (as a knife)
ˈfisaz: near
ˈsusaz: to tie
ˈxihuz: ice
ˈkixih: yellow
ˈafiz: meat
ˈʃutuh: cloud
ˈiʃuz: wet
ˈaʃah: to breathe
ˈutʃaz: sand
ˈkaz: salt
ˈhupiːz: seed
ˈsixuːz: tail
ˈahuz: to split
ˈʃiːxiz: straight
ˈihah: belly
ˈkasah: guts
ˈsuʃih: moon
ˈtʃaːh: snow
ˈsasih: smooth
ˈuxuːh: breast
ˈxih: smoke
ˈhaːh: tongue (organ)
ˈipah: to dig
ˈfiːz: round
ˈkuxuz: dirty
ˈatʃuh: stick
ˈfih: to flow
ˈxih: dust
ˈpuhaːh: to smell
ˈitʃuːz: to swim
ˈitih: to wipe
ˈsiːh: to rub
ˈxaːtʃih: rope
ˈxutʃah: to bite
ˈhiːh: fat (noun)
ˈuhiːz: to squeeze
ˈtafaːz: fingernail
ˈxuːh: to float
ˈxuːz: to freeze
ˈxuːh: dull (as a knife)
ˈpuhaːz: liver
ˈsuz: horn
ˈsihuh: to suck
ˈhuh: to hunt
ˈutʃaːh: rotten
ˈaːtʃah: feather
ˈafuh: ash
ˈiːfuz: louse
ˈtʃuxuh: snake
ˈaːpuz: worm
ˈsiz: to scratch
ˈxaːʃuh: to spit
ˈuhuːz: to vomit
ˈasaz: to stab
ˈfixih: fog
ˈhiːsaz: to swell
