ˈeːki: I
ˈajgaː: and
ˈaːtow: in
ˈawgu: not
ˈoːtej: you (singular)
ˈajnɛː: you (plural)
ˈɔkɔw: with
ˈedo: they (singular)
ˈumiː: they (plural)
ˈɛjŋa: at
ˈɛjta: this
ˈejkaj: we
ˈɛjbɛ: that
ˈɔwɢi: to say
ˈiːqɔ: what
ˈɔwkɔ: all
ˈowmiː: if
ˈajbej: who
ˈajbɔː: one
ˈowɴow: to see
ˈɛjŋɔː: to know
ˈunaw: some
ˈiŋe: year
ˈadoː: two
ˈɔtɔ: to think
ˈuda: to come
ˈiɴɔː: other
ˈito: to give
ˈiːko: good
ˈapuː: new
ˈitaw: how
ˈaɴɔw: man (adult male)
ˈudej: man (human being)
ˈedej: day
ˈite: many
ˈoqej: because
ˈɛjmɛj: three
ˈɛjbɛj: there
ˈɛjnaː: child
ˈɛːgaw: here
ˈawkɛː: old
ˈɛːti: woman
ˈawmo: where
ˈawkɛ: hand
ˈɛnɛj: small
ˈadɛj: to hold
ˈɛjku: four
ˈɛda: to turn (intransitive)
ˈeːnɔ: few
ˈuːŋaw: when
ˈone: five
ˈupɛj: head
ˈɛpe: night
ˈejne: long
ˈejdeː: eye
ˈugiː: to play
ˈeːbe: water
ˈajpe: to hear
ˈɛmu: right
ˈumɛ: big
ˈaːpi: to live
ˈɔwbɛj: to stand
ˈudoː: name
ˈipe: road
ˈeːbɛj: to sit
ˈɛtoː: mother
ˈejtoː: full
ˈoko: far
ˈɛːgi: to fall
ˈɛmiː: bad
ˈajnuː: father
ˈejta: black
ˈigi: to die
ˈaːtaw: to walk
ˈinow: foot
ˈoto: back
ˈejbe: white
ˈɛta: short
ˈɛjbɔː: wife
ˈepej: to lie (as in a bed)
ˈona: to cut
ˈɛjɴu: wide
ˈɔbo: to kill
ˈupɔ: animal
ˈaːqu: heart
ˈoneː: hair
ˈaqiː: tree
ˈoge: bark (of a tree)
ˈuːgu: fire
ˈamu: to eat
ˈɔwtej: to pull
ˈidow: sea
ˈowɴej: red
ˈajmɛj: dog
ˈiqɛj: husband
ˈɔwbu: leg
ˈɛjma: to throw
ˈɔwnow: sun
ˈajpaj: river
ˈumoː: stone
ˈibɔw: to fight
ˈabo: to hit
ˈiqoː: to push
ˈɔwnej: heavy
ˈipi: fish
ˈejgi: cold
ˈawduː: blood
ˈideː: green
ˈowqoː: star
ˈupa: mouth
ˈejnɔw: to laugh
ˈakow: earth
ˈetoː: left
ˈuːnɔ: bird
ˈawge: forest
ˈiːŋu: to fly
ˈoːgu: wind
ˈoːɢu: flower
ˈimɔ: skin
ˈoke: to drink
ˈoɴɛː: warm
ˈaboː: to sleep
ˈeɴɔ: mountain
ˈejna: rain
ˈawna: to sing
ˈoni: egg
ˈɔqaw: neck
ˈuːŋi: ear
ˈamɛː: correct
ˈeke: thin
ˈɛjmoː: sky
ˈimu: dry
ˈadaː: narrow
ˈeɴej: tooth
ˈuːgej: wing
ˈoːbɛj: to fear
ˈowdɔ: to burn
ˈabej: thick
ˈɛːmu: fruit
ˈunaj: leaf
ˈɔɴiː: to blow
ˈeɴow: lake
ˈaŋi: to sew
ˈemi: to count
ˈɔːbɛj: to wash
ˈajpow: nose
ˈiɢɛj: bone
ˈanoː: knee
ˈaːna: root
ˈani: grass
ˈoŋɛj: sharp (as a knife)
ˈemaw: near
ˈɛkɔw: to tie
ˈobe: ice
ˈake: yellow
ˈownɔw: meat
ˈowɴɔː: cloud
ˈɛːge: wet
ˈejniː: to breathe
ˈuːtu: sand
ˈɛɴɛː: salt
ˈɛke: seed
ˈiːdɛ: tail
ˈɛjmu: to split
ˈegaj: straight
ˈomaː: belly
ˈɔge: guts
ˈupɛː: moon
ˈuqej: snow
ˈebaw: smooth
ˈuqaː: breast
ˈuko: smoke
ˈɛjne: tongue (organ)
ˈoːde: to dig
ˈobiː: round
ˈoŋɔː: dirty
ˈɔwɢu: stick
ˈɔːɴɛ: to flow
ˈita: dust
ˈɔːpi: to smell
ˈawpaw: to swim
ˈowbɔː: to wipe
ˈobo: to rub
ˈeːgɔw: rope
ˈodi: to bite
ˈeːda: fat (noun)
ˈuːɴu: to squeeze
ˈɔŋaj: fingernail
ˈuniː: to float
ˈiqo: to freeze
ˈejɴu: dull (as a knife)
ˈopej: liver
ˈɔwbaw: horn
ˈejpiː: to suck
ˈoŋa: to hunt
ˈepe: rotten
ˈɔgɛ: feather
ˈiːku: ash
ˈede: louse
ˈema: snake
ˈejku: worm
ˈaːpu: to scratch
ˈejto: to spit
ˈebɛ: to vomit
ˈɛŋeː: to stab
ˈatu: fog
ˈipo: to swell
